testTexture.png
16
20
20
##################
#         #      #
#                #
#                #
#   #     #####  #
#   #         #  #
#   #   #     #  #
#             #  #
#####         #  ###
    #         #    #
    #   #     #    #
#####         ###  #
#                  #
#                  #
#      #    #      #
########    ###  ###
#      ######      #
#              ##  #
#                  #
####################