testTexture.png
16
20
15
##################
#         #      #
#  S             #
#                #
#   #     #####  #
#   #         #  #
#   #   #     #  #
#             #  #
#####         #  ###
    #         #    #
    #   #     #    #
#####         ###  #
#                  #
#                  #
####################